y# Gboard Dictionary version:2
# Gboard Dictionary format:shortcut	word	language_tag	pos_tag
weijianyequ	帷间夜曲	zh-CN	
heishi	黑蚀	zh-CN	
limingpoxiaozhishi	黎明破晓之史	zh-CN	
zhenyumixia	真语秘匣	zh-CN	
fangyetianjing	纺夜天镜	zh-CN	
xueranhuangcheng	血染荒城	zh-CN	
zhililunguang	支离轮光	zh-CN	
cangyao	苍耀	zh-CN	
xiangyunzouzhe	香韵奏者	zh-CN	
yicaixinnian	溢彩心念	zh-CN	
qinzhengyuechuqing	寝正月初晴	zh-CN	
fenyaotianyang	焚曜千阳	zh-CN	
jixingzhezhiwang	祭星者之望	zh-CN	
xingjiuchiyu	星鹫赤羽	zh-CN	
yanfengxunge	岩峰巡歌	zh-CN	
shanwangchangya	山王长牙	zh-CN	
chonglangshiguang	冲浪时光	zh-CN	
roudengwange	柔灯挽歌	zh-CN	
shezui	赦罪	zh-CN	
baiyuxinxian	白雨心弦	zh-CN	
chiyuezhixing	赤月之形	zh-CN	
youleyulianqie	有乐御簾切	zh-CN	
hemingyuyin	鹤鸣余音	zh-CN	
caiduan	裁断	zh-CN	
jingshuiliuyongzhihui	静水流涌之辉	zh-CN	
wanshilongyongdadian	万世流涌大典	zh-CN	
jinliujiandu	金流监督	zh-CN	
zuichudeamoshu	最初的大魔术	zh-CN	
biluozhilong	碧落之珑	zh-CN	
weihainbiao	苇海信标	zh-CN	
caiyecguang	裁叶萃光	zh-CN	
tulaiduladehuiyi	图莱杜拉的回忆	zh-CN	
qianyefumeng	千夜浮梦	zh-CN	
shengxianzhiyao	圣显之钥	zh-CN	
chishazhizhang	赤沙之杖	zh-CN	
lierenzhijing	猎人之径	zh-CN	
ruoshui	若水	zh-CN	
boluanyuebaijingjin	波乱月白经津	zh-CN	
shenyuezhizhenyi	神乐之真意	zh-CN	
xizai	息灾	zh-CN	
chijiaoshikuichu	赤角石溃杵	zh-CN	
dongjibaixing	冬极白星	zh-CN	
bumieyuehua	不灭月华	zh-CN	
ticaozhidaoguang	薙草之稻光	zh-CN	
wuqiezhihuiguang	雾切之回光	zh-CN	
feileizhixianzhen	飞雷之弦振	zh-CN	
cangguziyouzhishi	苍古自由之誓	zh-CN	
songlaixiangqizhishi	松籁响起之时	zh-CN	
zhongmojietanzhishi	终末嗟叹之诗	zh-CN	
panyanjielv	磐岩结绿	zh-CN	
humozhizhang	护摩之杖	zh-CN	
zhuofengzhiren	斫峰之刃	zh-CN	
wugongzhijian	无工之剑	zh-CN	
chenshizhisuo	尘世之锁	zh-CN	
guanhongzhishuo	贯虹之槊	zh-CN	
fengyingjian	风鹰剑	zh-CN	
tiankongzhiren	天空之刃	zh-CN	
tiankongzhiao	天空之傲	zh-CN	
langdemolu	狼的末路	zh-CN	
amoshigong	阿莫斯之弓	zh-CN	
tiankongzhiyi	天空之翼	zh-CN	
tiankongzhijuan	天空之卷	zh-CN	
sifengyuandian	四风原典	zh-CN	
hepuyuan	和璞鸢	zh-CN	
tiankongzhiji	天空之脊	zh-CN	
hongshediyuxian	虹蛇的雨弦	zh-CN	
shuangchen	霜辰	zh-CN	
shengjizhezhihuizhang	圣祭者的辉杖	zh-CN	
miyinchuisao	谧音吹哨	zh-CN	
zhiyuezhezhishuse	织月者的曙色	zh-CN	
wannengyaoshi	万能钥匙	zh-CN	
luowanggouzhen	罗网勾针	zh-CN	
tianguangdefangqin	天光的纺琴	zh-CN	
wusuiyedeng	乌髓孑灯	zh-CN	
juejinzhiqiao	掘金之锹	zh-CN	
shihuizhurong	拾慧铸熔	zh-CN	
lengjibengyin	冷寂迸音	zh-CN	
qiezutingyuduo	且住亭御咄	zh-CN	
eshuizhihuo	厄水之祸	zh-CN	
zhuihuazhiling	缀花之翎	zh-CN	
chenglangdehuixuan	乘浪的回旋	zh-CN	
mijianggu	弥坚骨	zh-CN	
shuoguogou	硕果钩	zh-CN	
zhenshanzhiding	镇山之钉	zh-CN	
xisuizhidi	息燧之笛	zh-CN	
handizhe	撼地者	zh-CN	
suilian	碎链	zh-CN	
mumianzhihuan	木棉之环	zh-CN	
cangwenjiaobei	苍纹角杯	zh-CN	
hongdexingji	虹的行迹	zh-CN	
zhuyun	筑云	zh-CN	
shazhongweixianeduida	沙中伟贤的对答	zh-CN	
jiujibawangchaojimojian	「究极霸王超级魔剑」	zh-CN	
shuixianshizhijian	水仙十字之剑	zh-CN	
chuanwuchangjian	船坞长剑	zh-CN	
bianxiedonglijv	便携动力锯	zh-CN	
cejugui	测距规	zh-CN	
wuyinweilanzhige	无垠蔚蓝之歌	zh-CN	
kantanzuanji	勘探钻机	zh-CN	
langya	狼牙	zh-CN	
huihedushou	灰河渡手	zh-CN	
haiyuanzhongqu	海渊终曲	zh-CN	
liaoliaobang	聊聊棒	zh-CN	
langyingkuojian	浪影阔剑	zh-CN	
lieyangzhisi	烈阳之嗣	zh-CN	
jingmizhiqu	静谧之曲	zh-CN	
chunshuiliuhua	纯水流华	zh-CN	
yisiyulong	遗祀玉珑	zh-CN	
xiawanchangge	峡湾长歌	zh-CN	
gongyidechoubao	公义的酬报	zh-CN	
huanchuanzhihui	鹮穿之喙	zh-CN	
shitiezhihua	饰铁之花	zh-CN	
donghuafangshiyu	东花坊时雨	zh-CN	
xifusideyueguang	西福斯的月光	zh-CN	
mahailadeshise	玛海菈的水色	zh-CN	
liulangdewanxing	流浪的晚星	zh-CN	
fengxinzhifeng	风信之锋	zh-CN	
yuanmudao	原木刀	zh-CN	
senlinwangqi	森林王器	zh-CN	
wangxiajinsi	王下近侍	zh-CN	
jieze	竭泽	zh-CN	
yingmanzhishi	盈满之实	zh-CN	
guanyueshi	贯月矢	zh-CN	
longdiaopingyixin	笼钓瓶一心	zh-CN	
luoxia	落霞	zh-CN	
zhengshizhimingtong	证誓之明瞳	zh-CN	
chenshazhifangchui	辰砂之纺锤	zh-CN	
ewangwan	恶王丸	zh-CN	
mengyunzhiyue	曚云之月	zh-CN	
duanlangchangqi	断浪长鳍	zh-CN	
xianzhuhaihuang	衔珠海皇	zh-CN	
lveshizhe	掠食者	zh-CN	
yuhuo	「渔获」	zh-CN	
tianmuyingdadao	天目影打刀	zh-CN	
guimuzhanchangzheng	桂木斩长正	zh-CN	
pomozhigong	破魔之弓	zh-CN	
baichenzhihuan	白辰之环	zh-CN	
xiduoyuanshiwenzi	喜多院十文字	zh-CN	
youyehuaerzi	幽夜华尔兹	zh-CN	
dudukegushiji	嘟嘟可故事集	zh-CN	
anxiangshanguang	暗巷闪光	zh-CN	
anxianglieshou	暗巷猎手	zh-CN	
fenghuazhisong	风花之颂	zh-CN	
anxiangdejiuyushi	暗巷的酒与诗	zh-CN	
qianyangujian	千岩古剑	zh-CN	
qianyanchangqiang	千岩长枪	zh-CN	
fuzhizhijian	腐殖之剑	zh-CN	
xuezangdexingyin	雪葬的星银	zh-CN	
rendongzhiguo	忍冬之果	zh-CN	
longjichangqiang	龙脊长枪	zh-CN	
xialilongyin	匣里龙吟	zh-CN	
tiefengci	铁蜂刺	zh-CN	
jilijian	祭礼剑	zh-CN	
heiyanchangjian	黑岩长剑	zh-CN	
zongshichangjian	宗室长剑	zh-CN	
dijian	笛剑	zh-CN	
shizuozhanyan	试作斩岩	zh-CN	
jianglinzhijian	降临之剑	zh-CN	
heijian	黑剑	zh-CN	
xifengjian	西风剑	zh-CN	
yucai	雨裁	zh-CN	
zhongjian	钟剑	zh-CN	
chigujian	螭骨剑	zh-CN	
jilidajian	祭礼大剑	zh-CN	
heiyanzhandao	黑岩斩刀	zh-CN	
zongshidajian	宗室大剑	zh-CN	
baiyingjian	白影剑	zh-CN	
xifengdajian	西风大剑	zh-CN	
shizuoguhua	试作古华	zh-CN	
jiligong	祭礼弓	zh-CN	
juexian	绝弦	zh-CN	
heiyanzhangong	黑岩战弓	zh-CN	
shizuodanyue	试作澹月	zh-CN	
zongshichanggong	宗室长弓	zh-CN	
ganglungong	钢轮弓	zh-CN	
cangcuiliegong	苍翠猎弓	zh-CN	
gongcang	弓藏	zh-CN	
xifengliegong	西风猎弓	zh-CN	
liulangyuezhang	流浪乐章	zh-CN	
wanguozhuhaitupu	万国诸海图谱	zh-CN	
jilicanchang	祭礼残章	zh-CN	
xialiriyue	匣里日月	zh-CN	
heiyanfeiyu	黑岩绯玉	zh-CN	
zongshimifalu	宗室秘法录	zh-CN	
shizuojinpo	试作金珀	zh-CN	
xifengmidian	西风秘典	zh-CN	
zhaoxin	昭心	zh-CN	
xialimiechen	匣里灭辰	zh-CN	
heiyancichang	黑岩刺枪	zh-CN	
juedouzhiqiang	决斗之枪	zh-CN	
zongshilieqiang	宗室猎枪	zh-CN	
shizuoxinglian	试作星镰	zh-CN	
xifengchangqiang	西风长枪	zh-CN	
liuyuezhen	流月针	zh-CN	
lengren	冷刃	zh-CN	
antiejian	暗铁剑	zh-CN	
feitianyujian	飞天御剑	zh-CN	
limingshenjian	黎明神剑	zh-CN	
luxingjian	旅行剑	zh-CN	
chihuyudao	吃虎鱼刀	zh-CN	
muyulongxuedejian	沐浴龙血的剑	zh-CN	
baitiedajian	白铁大剑	zh-CN	
feitandayujian	飞天大御剑	zh-CN	
tieyingkuojian	铁影阔剑	zh-CN	
yilifuren	以理服人	zh-CN	
yayugong	鸦羽弓	zh-CN	
shensheshouzhishi	神射手之誓	zh-CN	
dangong	弹弓	zh-CN	
fanqugong	反曲弓	zh-CN	
xinshi	信使	zh-CN	
mdaoxulun	魔导绪论	zh-CN	
feiyufaqiu	翡玉法球	zh-CN	
taolongyingjietan	讨龙英杰谭	zh-CN	
jiajibaojue	甲级宝珏	zh-CN	
yishijiexingji	异世界行记	zh-CN	
heiyingqiang	黑缨枪	zh-CN	
baiyingqiang	白缨枪	zh-CN	
yuemao	钺矛	zh-CN	
yinjian	银剑	zh-CN	
yongbingzhongjian	佣兵重剑	zh-CN	
lilandeliegong	历练的猎弓	zh-CN	
koudaimodaoshu	口袋魔导书	zh-CN	
tiejianqiang	铁尖枪	zh-CN	
wufengjian	无锋剑	zh-CN	
xunliandajian	训练大剑	zh-CN	
liegong	猎弓	zh-CN	
xuetubiji	学徒笔记	zh-CN	
xinshouchangqiang	新手长枪	zh-CN	
